0000000000000000
0000111000000100
0000111000000100
0000111000011100
0000000000000100
0001110000000100
0000011100000100
0001110000000100
0000011100000111
0000000000000111
0011111100000100
0010101000000100
0000000000000000
0000000011000000
0000011111110000
0000000000000000