00000000
01100130
01242110
03100110
00000000