00000000
01411000
01002000
01131310
00012110
00000110
00000000