000001111
041101111
012201000
012101030
000100030
100111130
101110110
101110000
100000111