11000000
11011110
00022210
04123310
01233300
00001101
11100001