1110000001
1000111101
0031200100
0332121140
0331212100
0000001101
1111100001