1000000011
1011111000
0020001110
0141211210
0133012100
0033011101
1000000001