10000000001
10110011101
10111211101
10210001201
10103330101
00103330100
01211211210
01111104110
00000000000