1110000000
1100110140
1101110110
1102121210
1101200110
0001210100
0333331101
0000000000