10000011
10410001
10121101
00010100
03010110
03211010
03111210
00000000