11000111
11030111
11010000
00021230
03124000
00002011
11103011
11100011