11000011
11033011
10013001
10112301
00121100
01102210
01141110
00000000