00000131
11100231
42221131
01101131
01100000