100001100000
001101101110
012100002110
011233331210
001111014100
100000000001